%%%%%%%%%%%%%%%%%%%%
%o...%........%..Go%
%.%%.%.%%..%%.%.%%.%
%...... G GG%......%
%.%.%%.%% %%%.%%.%.%
%.%....% ooo%.%..%.%
%.%.%%.% %% %.%.%%.%
%o%......P....%....%
%%%%%%%%%%%%%%%%%%%%
% % % % % % %%%%%%%%
%%%%%%%%%%%%%%%%%%%%